+--+--+--+--+--+--+--+--+--+--+
X  |              |        |  |
+  +  +--+--+--+  +  +  +  +  +
|  |  |     |     |  |  |  |  |
+  +  +  +--+  +--+  +  +  +  +
|  |  |     |        |  |     |
+  +  +  +  +--+--+--+  +  +--+
|  |  |  |     |     |  |  |  |
+  +  +  +--+  +  +  +  +  +  +
|     |     |     |     |     |
+--+--+--+  +--+--+--+--+--+--+
|        |     |     |     |  |
+  +--+  +--+  +  +  +  +  +  +
|     |        |  |  |  |  |  |
+--+  +--+--+--+--+  +  +  +  +
|     |              |  |  |  |
+  +--+  +--+--+--+  +--+  +  +
|        |        |        |  |
+  +--+--+  +--+  +--+--+--+  +
|           |                 O
+--+--+--+--+--+--+--+--+--+--+
