+--+--+--+--+--+--+--+--+--+--+
X  |     |                    |
+  +--+  +  +--+--+--+--+--+  +
|     |  |           |  |     |
+--+  +  +--+  +--+  +  +  +  +
|     |  |  |     |  |     |  |
+  +--+  +  +--+--+  +--+--+  +
|     |     |        |     |  |
+  +  +  +--+--+  +--+  +  +  +
|  |  |     |     |  |  |     |
+--+  +--+  +  +--+  +  +--+--+
|        |  |     |     |     |
+  +--+  +  +--+  +--+--+  +  +
|  |  |  |     |  |        |  |
+  +  +  +--+  +  +--+--+  +--+
|     |     |     |           |
+  +--+  +--+  +--+  +--+--+  +
|     |        |     |     |  |
+  +  +--+--+--+--+--+  +  +  +
|  |                    |     O 
+--+--+--+--+--+--+--+--+--+--+
